s                             s
sP                            s
s l   c     c     c     c    cs
ssls  s  s  s  s  s  s  s  ssss
s l                           s
s l                           s
s l                           <